-------HEADER-------------------------
-----------------TITLE----------------
--------------------------------------
--------------------------------------
--------------------------------------
--[              ]--------------------
--[  ° OPTION A  ]--------------------
--[  ° OPTION B  ]--------------------
--[              ]--------------------
--------------------------------------
--------------------------------------
--[                             ]-----
--[   FROM: -> TO:              ]-----
--[   rute option 1             ]-----
--[   rute option 2             ]-----
--[   rute option 3             ]-----
--[      °                      ]-----
--[      °                      ]-----
--[      °                      ]-----
--[                             ]-----
--------------------------------------
--------------------------------------
--------------------------------------
----------------[ TIME AND DATE ]-----
